车虫	其他
车内物品被盗	案件
称霸一方	其他
出租车换假币	其他
盗窃	案件
盗窃车内物品	案件
盗窃车牌	案件
盗窃电动车	案件
盗窃电动车电瓶	案件
盗窃机动车轮胎	案件
盗窃机动车燃油	案件
盗窃摩托车	案件
盗窃燃油助力车	案件
盗窃自行车	案件
电话诈骗	案件
赌博设备	其他
赌博信息	其他
短信诈骗	案件
房（地）出租	其他
房屋纠纷	其他
非法借贷讨债	其他
非法卖血	其他
分虫	其他
购物卡诈骗	案件
行霸市霸	其他
号贩子	其他
黑保安	其他
黑彩票	其他
黑车	其他
黑救护	其他
黑旅游	其他
黑中介	其他
酒托吧托	其他
开设赌场	其他
矿霸	其他
票贩子	其他
其他	其他
其他	 其他
强揽工程	其他
强买强卖	其他
semirob	案件
rob	案件
入室盗窃	案件
色情淫秽	其他
涉毒	其他
涉毒案件	其他
涉赌信息	其他
涉黄敲诈	案件
涉黄信息	其他
涉农	其他
涉外	其他
双抢	案件
私挖滥采	其他
贪污	其他
网络平台	其他
网络涉黄	其他
网络诈骗	案件
恶意竞标	其他
物流	其他
吸食注射毒品	其他
吸食注射毒品案件	其他
医闹纠纷	其他
医院号贩子	其他
诈骗	案件
招工诈骗	案件
招嫖卡片	其他
